.............
.............
......W...K..
####.....####
.............
.............
.....C.......
..#########..
.............
.............
.H.......M...
#####...#####
.............
.............
......K......
....#####....
.............
.............
......P......
#############
