.............
.............
......W...K..
####.....####
.............
.............
.....C.......
....#####....
.............
.............
....H....M...
...#######...
..##.....##..
.............
.............
.C...........
##.........##
.............
......P......
#############
