.............
.............
..H...W...C..
###.......###
.............
.............
...#######...
.............
C............
##.......H.##
.####...####.
.............
.............
.....###.....
....##.##....
.............
##.........##
.............
......P......
#############
